metapath	feature
CbGcGbCtD	dwpc_CbGcGbCtD
CbGcGdCtD	dwpc_CbGcGdCtD
CbGcGuCtD	dwpc_CbGcGuCtD
CbGdDpCtD	dwpc_CbGdDpCtD
CbGdDtCtD	dwpc_CbGdDtCtD
CbGiGuCtD	dwpc_CbGiGuCtD
CbGuDpCtD	dwpc_CbGuDpCtD
CdG<rGbCtD	dwpc_CdG<rGbCtD
CdG<rGdCtD	dwpc_CdG<rGdCtD
CdG<rGuCtD	dwpc_CdG<rGuCtD
CdGaDpCtD	dwpc_CdGaDpCtD
CdGcGbCtD	dwpc_CdGcGbCtD
CdGdDpCtD	dwpc_CdGdDpCtD
CdGdDtCtD	dwpc_CdGdDtCtD
CdGiGuCtD	dwpc_CdGiGuCtD
CdGr>GdCtD	dwpc_CdGr>GdCtD
CdGr>GuCtD	dwpc_CdGr>GuCtD
CdGuCtD	dwpc_CdGuCtD
CdGuCtDrD	dwpc_CdGuCtDrD
CdGuDpCtD	dwpc_CdGuDpCtD
CpDaGuCtD	dwpc_CpDaGuCtD
CpDdGdCtD	dwpc_CpDdGdCtD
CpDrDtCpD	dwpc_CpDrDtCpD
CpDtCbGuD	dwpc_CpDtCbGuD
CpDtCdGuD	dwpc_CpDtCdGuD
CpDtCpD	dwpc_CpDtCpD
CpDtCrCpD	dwpc_CpDtCrCpD
CpDtCtD	dwpc_CpDtCtD
CpDtCuGdD	dwpc_CpDtCuGdD
CpDtCuGuD	dwpc_CpDtCuGuD
CpDuGbCtD	dwpc_CpDuGbCtD
CrCbGuCtD	dwpc_CrCbGuCtD
CrCpDtCpD	dwpc_CrCpDtCpD
CrCpDtCtD	dwpc_CrCpDtCtD
CrCtDaGdD	dwpc_CrCtDaGdD
CrCtDaGuD	dwpc_CrCtDaGuD
CrCuGdCtD	dwpc_CrCuGdCtD
CtDaG<rGaD	dwpc_CtDaG<rGaD
CtDaG<rGdD	dwpc_CtDaG<rGdD
CtDaG<rGuD	dwpc_CtDaG<rGuD
CtDaGaDrD	dwpc_CtDaGaDrD
CtDaGbCpD	dwpc_CtDaGbCpD
CtDaGbCtD	dwpc_CtDaGbCtD
CtDaGcGaD	dwpc_CtDaGcGaD
CtDaGcGdD	dwpc_CtDaGcGdD
CtDaGcGuD	dwpc_CtDaGcGuD
CtDaGdAlD	dwpc_CtDaGdAlD
CtDaGdCpD	dwpc_CtDaGdCpD
CtDaGdCtD	dwpc_CtDaGdCtD
CtDaGdD	dwpc_CtDaGdD
CtDaGdDrD	dwpc_CtDaGdDrD
CtDaGeAlD	dwpc_CtDaGeAlD
CtDaGiGaD	dwpc_CtDaGiGaD
CtDaGiGdD	dwpc_CtDaGiGdD
CtDaGiGuD	dwpc_CtDaGiGuD
CtDaGr>GaD	dwpc_CtDaGr>GaD
CtDaGr>GdD	dwpc_CtDaGr>GdD
CtDaGr>GuD	dwpc_CtDaGr>GuD
CtDaGuAlD	dwpc_CtDaGuAlD
CtDaGuCpD	dwpc_CtDaGuCpD
CtDaGuCtD	dwpc_CtDaGuCtD
CtDaGuD	dwpc_CtDaGuD
CtDaGuDrD	dwpc_CtDaGuDrD
CtDdG<rGaD	dwpc_CtDdG<rGaD
CtDdG<rGdD	dwpc_CtDdG<rGdD
CtDdG<rGuD	dwpc_CtDdG<rGuD
CtDdGaD	dwpc_CtDdGaD
CtDdGaDrD	dwpc_CtDdGaDrD
CtDdGbCpD	dwpc_CtDdGbCpD
CtDdGbCtD	dwpc_CtDdGbCtD
CtDdGcGaD	dwpc_CtDdGcGaD
CtDdGcGdD	dwpc_CtDdGcGdD
CtDdGcGuD	dwpc_CtDdGcGuD
CtDdGdAlD	dwpc_CtDdGdAlD
CtDdGdCpD	dwpc_CtDdGdCpD
CtDdGdCtD	dwpc_CtDdGdCtD
CtDdGdDrD	dwpc_CtDdGdDrD
CtDdGeAlD	dwpc_CtDdGeAlD
CtDdGiGaD	dwpc_CtDdGiGaD
CtDdGiGdD	dwpc_CtDdGiGdD
CtDdGiGuD	dwpc_CtDdGiGuD
CtDdGr>GaD	dwpc_CtDdGr>GaD
CtDdGr>GdD	dwpc_CtDdGr>GdD
CtDdGr>GuD	dwpc_CtDdGr>GuD
CtDdGuAlD	dwpc_CtDdGuAlD
CtDdGuCpD	dwpc_CtDdGuCpD
CtDdGuCtD	dwpc_CtDdGuCtD
CtDdGuD	dwpc_CtDdGuD
CtDdGuDrD	dwpc_CtDdGuDrD
CtDlAdGaD	dwpc_CtDlAdGaD
CtDlAdGdD	dwpc_CtDlAdGdD
CtDlAdGuD	dwpc_CtDlAdGuD
CtDlAeGaD	dwpc_CtDlAeGaD
CtDlAeGdD	dwpc_CtDlAeGdD
CtDlAeGuD	dwpc_CtDlAeGuD
CtDlAuGaD	dwpc_CtDlAuGaD
CtDlAuGdD	dwpc_CtDlAuGdD
CtDlAuGuD	dwpc_CtDlAuGuD
CtDpCbGaD	dwpc_CtDpCbGaD
CtDpCbGdD	dwpc_CtDpCbGdD
CtDpCbGuD	dwpc_CtDpCbGuD
CtDpCdGaD	dwpc_CtDpCdGaD
CtDpCdGdD	dwpc_CtDpCdGdD
CtDpCdGuD	dwpc_CtDpCdGuD
CtDpCrCtD	dwpc_CtDpCrCtD
CtDpCtD	dwpc_CtDpCtD
CtDpCtDrD	dwpc_CtDpCtDrD
CtDpCuGaD	dwpc_CtDpCuGaD
CtDpCuGdD	dwpc_CtDpCuGdD
CtDpCuGuD	dwpc_CtDpCuGuD
CtDrDaGdD	dwpc_CtDrDaGdD
CtDrDaGuD	dwpc_CtDrDaGuD
CtDrDdGaD	dwpc_CtDrDdGaD
CtDrDdGdD	dwpc_CtDrDdGdD
CtDrDdGuD	dwpc_CtDrDdGuD
CtDrDpCtD	dwpc_CtDrDpCtD
CtDrDuGaD	dwpc_CtDrDuGaD
CtDrDuGdD	dwpc_CtDrDuGdD
CtDrDuGuD	dwpc_CtDrDuGuD
CtDtCbGaD	dwpc_CtDtCbGaD
CtDtCbGdD	dwpc_CtDtCbGdD
CtDtCbGuD	dwpc_CtDtCbGuD
CtDtCdGaD	dwpc_CtDtCdGaD
CtDtCdGdD	dwpc_CtDtCdGdD
CtDtCdGuD	dwpc_CtDtCdGuD
CtDtCpD	dwpc_CtDtCpD
CtDtCpDrD	dwpc_CtDtCpDrD
CtDtCrCpD	dwpc_CtDtCrCpD
CtDtCuGaD	dwpc_CtDtCuGaD
CtDtCuGdD	dwpc_CtDtCuGdD
CtDtCuGuD	dwpc_CtDtCuGuD
CtDuG<rGaD	dwpc_CtDuG<rGaD
CtDuG<rGdD	dwpc_CtDuG<rGdD
CtDuG<rGuD	dwpc_CtDuG<rGuD
CtDuGaD	dwpc_CtDuGaD
CtDuGaDrD	dwpc_CtDuGaDrD
CtDuGbCpD	dwpc_CtDuGbCpD
CtDuGbCtD	dwpc_CtDuGbCtD
CtDuGcGaD	dwpc_CtDuGcGaD
CtDuGcGdD	dwpc_CtDuGcGdD
CtDuGcGuD	dwpc_CtDuGcGuD
CtDuGdAlD	dwpc_CtDuGdAlD
CtDuGdCpD	dwpc_CtDuGdCpD
CtDuGdCtD	dwpc_CtDuGdCtD
CtDuGdD	dwpc_CtDuGdD
CtDuGdDrD	dwpc_CtDuGdDrD
CtDuGeAlD	dwpc_CtDuGeAlD
CtDuGiGaD	dwpc_CtDuGiGaD
CtDuGiGdD	dwpc_CtDuGiGdD
CtDuGiGuD	dwpc_CtDuGiGuD
CtDuGr>GaD	dwpc_CtDuGr>GaD
CtDuGr>GdD	dwpc_CtDuGr>GdD
CtDuGr>GuD	dwpc_CtDuGr>GuD
CtDuGuAlD	dwpc_CtDuGuAlD
CtDuGuCpD	dwpc_CtDuGuCpD
CtDuGuCtD	dwpc_CtDuGuCtD
CtDuGuD	dwpc_CtDuGuD
CtDuGuDrD	dwpc_CtDuGuDrD
CuG<rGbCtD	dwpc_CuG<rGbCtD
CuG<rGdCtD	dwpc_CuG<rGdCtD
CuG<rGuCtD	dwpc_CuG<rGuCtD
CuGaDpCtD	dwpc_CuGaDpCtD
CuGcGbCtD	dwpc_CuGcGbCtD
CuGdCtD	dwpc_CuGdCtD
CuGdCtDrD	dwpc_CuGdCtDrD
CuGdDpCtD	dwpc_CuGdDpCtD
CuGiGbCtD	dwpc_CuGiGbCtD
CuGiGdCtD	dwpc_CuGiGdCtD
CuGiGuCtD	dwpc_CuGiGuCtD
CuGr>GdCtD	dwpc_CuGr>GdCtD
CuGr>GuCtD	dwpc_CuGr>GuCtD
CuGuDpCtD	dwpc_CuGuDpCtD
CuGuDtCpD	dwpc_CuGuDtCpD
